=====================================================
=====================================================
=====================================================
=====================================================
===========###############################==============
===========#=======================#######==============
===========#=====##============#=#=#=====#==============
===========#===#######=========#=#=#=##==#==============
===========#======##===========#=#=#==#=##==============
===========#===================#=#=#==#-##==============
===========#===================#==##==####==============
===========#####===============#=====#####==============
===========#%========##========###########==============
===========######====##=====##=========###==============
===========######====##===#####=========###==============
===========#=====#=====================###==============
===========#====##============#######==###==============
===========#======#########====###=======#==============
===========#==========###===##=======##==#==============
===========#==============################==============
===========#=######================@===###==============
===========###############################=============
=====================================================
=====================================================
=====================================================
=====================================================